20, 21, 21, 21, 21, 21, 21, 21, 21, 21, 21, 21, 21, 21, 21, 21, 21, 21, 21, 21, 21, 21, 21, 21, 22,
26, 26, 26, 26, 26, 26, 26, 26, 26, 26, 26, 26, 26, 26, 26, 26, 26, 26, 26, 26, 26, 29, 28, 29, 32,
25, 26, 29, 28, 26, 26, 26, 26, 26, 26, 26, 26, 26, 29, 28, 26, 26, 26, 26, 26, 26, 24, 23, 24, 22,
25, 26, 24, 23, 26, 26, 29, 31, 31, 28, 26, 26, 26, 24, 23, 26, 26, 29, 31, 31, 31, 31, 31, 31, 32,
25, 26, 26, 26, 26, 26, 27, 20, 22, 25, 26, 26, 26, 26, 26, 26, 26, 24, 21, 21, 21, 21, 22, 20, 22,
25, 26, 26, 26, 26, 26, 27, 30, 32, 25, 26, 26, 26, 26, 26, 26, 29, 31, 31, 31, 31, 28, 27, 25, 27,
25, 26, 26, 26, 26, 26, 24, 21, 21, 23, 26, 26, 26, 26, 26, 26, 27, 02, 16, 14, 04, 25, 27, 25, 27,
25, 26, 26, 26, 26, 26, 26, 26, 26, 26, 26, 29, 31, 31, 31, 31, 32, 19, 08, 09, 10, 25, 27, 25, 27,
25, 26, 29, 28, 26, 26, 26, 26, 26, 26, 26, 24, 21, 21, 21, 21, 21, 21, 21, 21, 21, 23, 27, 25, 27,
25, 26, 24, 23, 26, 26, 26, 26, 26, 26, 26, 29, 31, 31, 31, 31, 31, 31, 31, 31, 31, 31, 32, 25, 27,
25, 26, 26, 26, 26, 26, 26, 26, 26, 26, 26, 24, 21, 21, 21, 21, 21, 21, 21, 21, 21, 21, 21, 23, 27,
25, 26, 26, 26, 26, 26, 26, 29, 28, 26, 26, 26, 26, 26, 26, 26, 26, 26, 26, 26, 26, 26, 26, 26, 27,
25, 26, 26, 26, 26, 26, 26, 24, 23, 26, 29, 31, 31, 31, 31, 31, 31, 31, 28, 26, 29, 31, 31, 28, 27,
25, 26, 29, 31, 31, 28, 26, 26, 26, 26, 27, 02, 02, 02, 18, 01, 01, 01, 25, 26, 27, 20, 22, 25, 27,
25, 26, 27, 20, 22, 25, 26, 26, 26, 26, 27, 02, 02, 19, 04, 02, 07, 06, 25, 26, 27, 30, 32, 25, 26,
25, 26, 27, 30, 32, 25, 26, 26, 26, 26, 27, 02, 15, 16, 09, 14, 02, 02, 25, 26, 24, 21, 21, 23, 27,
25, 26, 24, 21, 21, 23, 26, 26, 26, 26, 27, 02, 15, 08, 09, 10, 01, 01, 30, 28, 26, 26, 26, 26, 27,
30, 31, 31, 31, 31, 31, 31, 31, 31, 31, 32, 02, 02, 11, 12, 13, 04, 04, 17, 30, 31, 31, 31, 31, 32,
02, 19, 02, 07, 07, 02, 02, 02, 02, 02, 07, 02, 02, 02, 07, 02, 08, 10, 06, 06, 01, 01, 01, 02, 01,
02, 02, 19, 02, 07, 02, 02, 02, 02, 19, 02, 02, 15, 02, 02, 02, 03, 05, 19, 01, 07, 01, 01, 02, 07
0 32
780 444
