20, 21, 21, 21, 21, 21, 21, 21, 21, 21, 21, 21, 21, 21, 21, 21, 21, 21, 21, 21, 21, 21, 21, 21, 22,
26, 26, 26, 26, 26, 26, 26, 26, 26, 26, 29, 31, 31, 31, 31, 31, 31, 28, 26, 29, 31, 31, 31, 28, 27,
30, 31, 31, 28, 26, 26, 26, 26, 26, 26, 24, 21, 21, 21, 21, 21, 21, 23, 29, 32, 04, 04, 04, 30, 32,
20, 21, 21, 23, 26, 26, 26, 29, 31, 31, 28, 26, 26, 26, 26, 26, 26, 26, 27, 16, 09, 09, 09, 14, 07,
25, 26, 26, 29, 28, 29, 31, 32, 20, 22, 30, 31, 31, 31, 31, 31, 31, 28, 27, 03, 09, 09, 09, 10, 06,
25, 26, 26, 24, 23, 24, 21, 22, 30, 32, 01, 01, 01, 01, 01, 01, 01, 25, 24, 22, 11, 12, 13, 13, 07,
25, 26, 26, 26, 26, 26, 29, 32, 02, 02, 20, 21, 21, 21, 22, 06, 07, 25, 26, 26, 21, 21, 21, 21, 22,
25, 26, 26, 26, 26, 26, 27, 02, 02, 02, 25, 26, 26, 26, 27, 06, 06, 25, 26, 26, 26, 26, 26, 26, 27,
25, 26, 26, 26, 26, 26, 24, 21, 21, 22, 25, 29, 28, 26, 27, 15, 06, 25, 26, 26, 26, 26, 26, 26, 27,
30, 31, 31, 31, 31, 28, 26, 26, 26, 24, 23, 24, 23, 26, 27, 06, 15, 25, 26, 26, 26, 26, 26, 26, 27,
19, 06, 06, 06, 06, 25, 26, 26, 29, 31, 28, 29, 28, 26, 27, 06, 06, 25, 29, 31, 31, 31, 31, 28, 27,
02, 19, 20, 22, 06, 25, 26, 26, 27, 06, 30, 32, 30, 31, 32, 06, 06, 25, 27, 02, 02, 02, 02, 25, 27,
02, 02, 30, 32, 06, 25, 26, 26, 27, 06, 06, 06, 06, 07, 06, 06, 06, 25, 27, 02, 20, 22, 06, 25, 27,
02, 02, 02, 17, 06, 25, 26, 26, 27, 15, 06, 06, 20, 21, 21, 21, 21, 23, 27, 02, 30, 32, 06, 25, 27,
20, 21, 21, 21, 21, 23, 26, 26, 27, 06, 07, 06, 25, 29, 28, 26, 26, 26, 27, 07, 02, 02, 02, 25, 26,
25, 26, 26, 26, 26, 26, 26, 26, 24, 21, 22, 06, 25, 27, 25, 26, 26, 26, 24, 21, 21, 21, 21, 23, 27,
25, 26, 26, 26, 26, 26, 26, 26, 26, 26, 27, 06, 25, 24, 23, 26, 26, 26, 26, 26, 26, 26, 29, 31, 32,
25, 26, 29, 31, 31, 28, 26, 26, 26, 26, 27, 06, 25, 26, 26, 26, 26, 26, 26, 26, 26, 26, 27, 02, 02,
30, 31, 32, 06, 02, 30, 31, 31, 31, 31, 32, 07, 30, 31, 31, 31, 31, 31, 31, 31, 31, 31, 32, 02, 02,
01, 02, 06, 06, 06, 02, 02, 02, 02, 02, 02, 02, 15, 07, 15, 17, 18, 17, 15, 15, 01, 01, 02, 06, 06
0 32
780 444